
Mã: company
Sàn: platform
Year: year


EBITDA: ebitda
Doanh thu thuần: revenue
Lợi nhuận thuần từ hoạt động kinh doanh: net_op_profit
ROA %: roa
ROE %: roe

Giá vốn hàng bán: cogs
Chi phí bán hàng: sales_cost
Chi phí quản lý doanh  nghiệp: admin_cost


Các khoản phải thu ngắn hạn: short_receive
Hàng tồn kho ròng: in_stock
Giá trị ròng tài sản đầu tư: invest_nav
Phải thu dài hạn: long_receive
Tiền và tương đương tiền: cash
Tài sản cố định: fixed_asset
Tài sản dài hạn khác: other_long_asset
Tài sản dở dang dài hạn: cwip
Tài sản ngắn hạn khác: other_short_asset
Đầu tư dài hạn: long_invest

Nợ dài hạn: long_liability
Nợ ngắn hạn: short_liability

Vốn và các quỹ: equity_fund
Nguồn kinh phí và quỹ khác: other_fund

Tỷ lệ sở hữu nhà nước: gov_own
Tỷ lệ sở hữu nước ngoài: for_own

Vốn hóa thị trường: market_cap
Giá trị doanh nghiệp (EV): ev
ROIC %: roic
ROCE %: roce